14, 2, 2, 2, 2, 2, 2, 2, 2, 2, 2, 2, 2, 2, 2, 2, 
2, 2, 2, 2, 13,
11, 14, 2, 2, 2, 2, 2, 2, 2, 2, 2, 2, 2, 2, 2, 2, 
2, 2, 2, 13, 7,
11, 11, 14, 3, 3, 3, 3, 3, 3, 3, 3, 3, 3, 3, 3, 3, 
3, 3, 13, 7, 7,
11, 11, 12, 1, 1, 1, 1, 1, 1, 1, 1, 1, 1, 1, 1, 1, 
1, 1, 8, 7, 7,
11, 11, 12, 1, 1, 1, 1, 1, 1, 1, 1, 1, 1, 1, 1, 1, 
1, 1, 8, 7, 7,
11, 11, 12, 1, 1, 1, 1, 1, 1, 1, 1, 1, 1, 1, 1, 1, 
1, 1, 8, 7, 7,
11, 11, 12, 1, 1, 1, 1, 1, 1, 1, 18, 1, 1, 1, 1, 1, 
1, 1, 8, 7, 7,
11, 11, 12, 1, 1, 1, 1, 1, 1, 1, 1, 1, 1, 1, 1, 1, 
1, 1, 8, 7, 7,
11, 11, 12, 1, 1, 1, 1, 1, 1, 1, 1, 1, 1, 1, 1, 1, 
1, 1, 8, 7, 7,
11, 11, 12, 1, 1, 1, 1, 1, 1, 1, 1, 1, 1, 1, 1, 1, 
1, 1, 8, 7, 7,
11, 11, 16, 10, 10, 10, 10, 10, 10, 10, 21, 10, 10, 10, 10, 10, 
10, 10, 15, 7, 7,
11, 16, 9, 9, 9, 9, 9, 9, 9, 9, 22, 9, 9, 9, 9, 9, 
9, 9, 9, 15, 7,
16, 9, 9, 9, 9, 9, 9, 9, 9, 9, 9, 9, 9, 9, 9, 9, 
9, 9, 9, 9, 15